alias zshconfig="vim ~/.zshrc"
alias upzshrc="source ~/.zshrc"
alias viedit="vim ~/.vimrc"
alias actualizar="sudo apt update -y && sudo apt upgrade -y && sudo apt dist-upgrade -y"
alias reinicio="systemctl reboot"
alias apagado="systemctl poweroff"
alias ngreload="sudo nginx -s reload"
alias ngcheck="sudo nginx -t"
alias pypass="python3 ~/.pypass/pass.py --namepass"
alias covim="vim ~/.vimrc"
alias sshdres="sudo systemctl restart sshd"
alias sshstop="sudo sysremctl stop sshd"
alias sshdstatus="sudo systemctl status sshd"
alias resnet="sudo systemctl restart NetworkManager"
alias resmini="sudo systemctl restart minidlna"
alias susy="sudo systemctl"
alias ifconfig="sudo ifconfig"
alias gita="git add ."
alias gitc="git commit -S -m"
alias gitps="git push -u origin"
alias gitp="git pull"
alias gitm="git merge"
alias gitcc="git checkout"
alias torz1="source torsocks on"
alias torz0="source torsocks off"
alias cfc="xclip -sel c"
alias runflask="flask run --host=192.168.0.10"
alias fmigrate="flask db migrate -m"
alias fupgrade="flask db upgrade"
alias fshell="flask shell"
